8
....++..
.g...+..
..+..+..
++......
........
..+++...
..i.....
........
