12
.....+++++++
..++++....g+
.++.........
..++........
+......+++++
+...+.......
+......+++++
+...+++++...
......++....
.........+++
.+++........
+.i.........
